

               	NO text/anis.xpm

WE 		text/arepa.xpm
    SO      text/fcb.xpm

         F 23,43,20

EA          text/cachapa.xpm

C 			22               ,      244                    ,253

          1111111111111111111111111
          1000000000110000000000001
          1011000001110000000000001
          1001000000000000000000001
 1111111110110000011100000000000011
 1000000000110000011101100011111111
 11110111111111011100010010001
 111101111111110111011 1010001
 11000000110101011100010010001
 10000000000000001100000010001
 10000000000000001101010010001
 1100000111010101111101111N0111
 11110111 1110101 101111010001
 11111111 1111111 111111111111
















