NO text/rook.xpm
WE text/pawn.xpm
SO text/knigh2.xpm
EA text/bishop.xpm

F 232,40,50
C 112,144,253


1111111111111111111111111111111111
1000000S00000000000000000000000001
1000000000000000000000000000000001
1000000000000000000000000000000001
1000000111111111111111111111000001
10000001                   1000001
10000001                   1000001
10000001                   1000001
10000001                   1000001
10000001                   1000001
10000001                   1000001
10000001                   1000001
1000000111111111111111111111000001
1000000000000000000000000000000001
1000000000000000000000000000000001
1000000000000000000000000000000001
1000000000000000000000000000000001
1111111111111111111111111111111111