NO text/rook.xpm
WE text/pawn.xpm
SO text/knigh2.xpm
EA text/bishop.xpm

F 232,40,50
C 112,144,253

11111111111111111111111111111111
10000000000000000000000000000001
10000000000000000000000000000001
10000000000000000000000000000001
10000000000000000000000000000001
10000000000000000000000000000001
10000000000000000000000000000001
10000000000000000000000000000001
10000000000000000000000000000001
10000000000000000S00000000000001
10000000000000000000000000000001
10000000000000000000000000000001
10000000000000000000000000000001
100000000000000000000000000000011111111111111111111111111
111111111111111111111100000000000000000000000000000111111
111111111111111111111111111111000000000000000000000111111
111111111111111111111111111111111111000000000000000000111
                                    100000000000000000111
                                    100000000000000000111
                                    100000000000000000111
                                    100000000000000000111
                                    100000000000000000111
                                    100000000000000000111
                                    100000000000000000111
                                    100000000000000000111
                                    100000000000000000111
                                    100000000000000000111
                                    100000000000000000111
                                    100000000000000000111
                                    100000000000000000111
                                    100000000000000000111
                                    100000000000000000111
                                    100000000000000000111
                                    100000000000000000111
                                    111111111111111111111

