          

     	NO textures/test/north.xpm


SO textures/test/south.xpm

         F 200,200,200
WE 		textures/test/west.xpm

EA          textures/test/east.xpm

C 			200,444,200     


			1111111111
			1000000001
1111111111111111111111
1000000001
1000000001
1000N00001
1111111111