

               	NO textures/test/north.xpm


WE 		textures/test/west.xpm
    SO      textures/test/south.xpm

         F 253,43,20

EA          textures/test/east.xpm

C 			22               ,      244                    ,253


     111111111
    10000100001
   1000001000001
  10000S000000001
 10000000000000001
1100000000000000011
1111111111111111111
   11111    111111

























