

               	NO textures/test/north.xpm


WE 		textures/test/west.xpm
    SO      textures/test/south.xpm

         F 200,200,200

EA          textures/test/east.xpm

C 			200,444,200

1111111111111111111111111111111111111111
1000000000000000000000000000000000000001
1000000000000000000000000000000000000001
10000000000000000000000000000000000000001
1000000000000000000000000000000000000001
1000000000000000010000000000000000000001111111
10000000000000001 10000000S000000000000000001
100000000000000001000000000000000000000111111
1000000000000000000000000000000000000001
1000000000000000000000000000000000000001
1000000000000000000000000000000000000001
1000000000000000000000000000000000000001
1000000000000000000000000000000000000001
1000000000000000000000000000000000000001
1000000000000000000000000000000000000001
1111111111111111111111111111111111111111
