

               	NO text/anis.xpm


WE 		text/arepa.xpm
    SO      text/knight.xpm

         F 253,43,20

EA          text/cachapa.xpm

C 			22               ,      244                    ,253


     111111111
    10000100001
   1000001000001
  100000000000001
 11100000000000001
11S0000000000000011
1111111111111111111
   11111    111111

























