

               	NO text/anis.xpm

WE 		text/arepa.xpm
    SO      text/knight.xpm

         F 23,43,20

EA          text/wood.xpm

C 			22               ,      244                    ,253


     111111111
    10000100001
   1000001000001
  100000100000001
 1110001 100000001
11E0000010000000011
1111111111111111111
   11111    111111





















