          

     	NO textures/test/north.xpm


SO textures/test/south.xpm

         F 200,200,200
WE 		textures/test/west.xpm

EA          textures/test/east.xpm

C 			200,444,200

111111
100101
101001
1100N1
111111